Baranowski   Kamil                 : KSAHDCEIKOKRFWARKODFUZISWXCBEWCKYNRIRVATZTHUCLXHHDARFGMBODPSCKSKBNRNYPXDDUKEYJTSWQTJHXLZRQCYLPKGXOAQINXJXQAYRZEDYSBTTXSDAAAGWOOVDHPZOAUGUKWTODBDBCFSOABZOFGTFPZWGMQVEABMPOIZPJO
Barański     Patryk     Adam       : TRGBJQFTBGUFQNYGBTUXYAGQYYOXQKMPOYXKZEDDNAYVAEIDVIYPWVXLOUHMPAPLUIXPEUPBKRXAZJZPVOQHPTWTSWIRLJKKIQLZRFLIUWXRHGWNUOTNUOMIBJCZEVWROEMIFPIXXGCFMSFGWKQGCNMDQORDTFNUAIWVNWYVWCQSPUA
Biernat      Mateusz               : UTGGQIULUZHDXOZQZONDJAETAJWSRELPZFGGTLBNFUHAPVJTNOYUASMYFGCLCQUSTIVLVQDCABLCATKTLLMMUKXAUDQAOAYXUXDEEQXZSTXKGEDVDGVIZGNIXJLNYASXANIWORLQHAOINXLGJYYVXFCFIEPKVESGOJBFRMNEOZVPZXP
Bocheński    Tomasz     Mateusz    : ACBLJZEZTVQRMAJMSMLDATIZFINTMDINRUDANVARRLXQAMWVQRPHORJWFTHULVJFTITTFFFDJACRUCGFXSOHVLYSMDZEFLKDSEQTFPTQPHTYLUBVEKHCXJNMDFBNGJCUCZEOBUENTDOFTSEWAWOKTSZHAYWSNSUJUTPKSAUXGDFHWOH
Bogusz       Konrad                : DHPILLVLIRFMIQWLULRDLXPTNMVBOYNFWGSOYQVAZCIYAVWLGUMDYXMWKRKNEZHCDASOUNUSUKQEIEKGKZIZQJWQGULJISGVHOMWXEPXLXHPRFAKYIUEIDSSRGSFLJJBQSPQEDNWEMLMEIGVULPDNHWRQDMZYQDQOMLPWTPYBZBFKCQ
Bogusz       Maciej     Jan        : BHBSRJETIUMNAQJFLJMZJUOXJGXBYOJZBNAOEQZWLSUMNDJDSMLXNKGBKAHNZCRMUDCKUETHFAKJRBDACQKIOZVSXBBMJYMOXLWGHIOFRDCWGKONBWYVHNIOZIRIUIXTTMFBIASRLTNBDFIBPNQLWLAWRVYBGBKWCMDUVBMGYYPZIXL
Borkowski    Stanisław  Jerzy      : GYRBWSPTGPVBDVQNGHWKBXFVWMPNQWHWOCFPGDEVPZIPPQBTYNFTAIXPWPVWIDSLDPAFUAHAZPHYNLPGHJGPSBZTUTCMLRLSRSQDTUXGEKIVPTLCCJFVPRMCGMFASSIVLWRPFNXHWXIRXBWEWRIDQWVQYPFLIZJZNEBJDQKZYDKMOUM
Cendrowski   Marcin                : KGXAVERJZDEXPIAFDFXWSMVMJHYKMGXJHSEDVTPGQQIBWLTGPLJDGCHTPRARNGEEVZXJUOVMPUCNJPYKKUQKRKDLIFYRPTOSYWEGBZGRCFNCKNIONKSRROJPYPZLTATNAHNTBOUQYBHXTPVXZZDBBAZCVRMJJGXSALHAXUIUIIYZNYX
Dailida      Andrei                : NJSLPZUICENKUYEWYYABAIBHJYMHNQCTWVXJLCFZHXXXEWQFIELCEFROWGQANWZAGFBAMBHQHHPJSMQJHDYUYEYYHHOELEYMZQMZDQRLBMMUGKGRZEVGBDYXHYWLMQEAGAROIUDGHFCWCRDAOXWIAUUWRVXLONRRNVNVHEZTGPYCCQF
Duniewicz    Hubert     Paweł      : TORCCQKCJREXYZSKTHIPPWGTYAMRVEWJXACZPKEQAIIPQVYRPKZEXIORGENUSDXMYOCFWSXINQPGLGVZBSIQGQJHXYPFYTTFVGQSTKTXPCDCEDUBGWZPZBYIUVWLYGYQZASOMGIGFUNCUNTNKZAYYKFQEUGHXXNWJZLHBZMTQSBXYOZ
Foryszewski  Kamil      Krystian   : HPKQHVBBBDKYCQNJFFBSQLSCYWRJKMYWMOWYQTJXVOWWVDNXUKZGIYVXAJGHTSMJPNOQKUGRYASCOQGXQGUCOCPGQSNRVUQLKWSEOXDVVMADXBJQFZEOQGMMTQMRLNREUPZFMXPSKRYFUZAFDTCZKXELVPMNOLFCDBOWJBLPLVYWSMR
Frysz        Piotr      Ryszard    : AZEXUUGFLWLYJQZQBMINHDRRWDUVQFGKOMMVWVWOZPPIRBDDREIBGZNDNYWKHTGGCWLOTULEVAYPWPGHNZENIUULFBFHPWDYRTZKNRNHCHTQUNGQHAXKLTYBEIGMVWPGETGOTFEBDWCFARGKDJLMKCUDLHHRNEMISFVNNGEMZDHURHI
Gosk         Emilia                : KPSWRGYUHHWDQHVJTFMUKEQTHLXWSPVXAKOTCKHLMRMQPLAFIDPPNIQEATLSEBJSCFLQTCQKRFNEAMEQNUKZNMTOJMEKAMHNAOHPTLRGZGYFMVSSLTXLNBKMXCTOPADHARWOOQHJOVFITIBEFMQWXHTHJHKFIDZNYTLTQHNSHAGUYQD
Grudziąż     Maciej     Jakub      : TNTWYRWTSWXXKCVOOVAWASPQJHNXORLZTJQOWHCEKWHQQKBTHKJRCOAZPJDSXITHYSQYGYRUOVSDPHXFHBLOOXJLWORHMQDACMAQCGLDHAZPJAKLYHPRENUCPAABMYKBWNIZYGFPVIPEFTDGRAAHIJUAJQDWQCFTKMXDZBCFULQEENT
Gryta        Radosław   Andrzej    : MWRGGJTYWGKPOKCSCWWSMSKUUEIIJOBRFKLJJEBOPDGHVDOOIJYOQMQPDILDJFWIFKRBESTQWESXDGOIRBESZYXDDBOWNUEWEBKOZCHCKHNJYUWDOFWACJKHCDIYFTGAADMTSJMVVIABTHMEWNNHNAHJHCNUYMPHDDTTEKPDUQPSZOW
Jabłoński    Paweł                 : KRYRHQJIPEMYJEMVVVAGZDMUDRMFWEQTOQDIPKRWEXJYQUNNIDJFAHEWCESXGAYRIMPJWSYJYMQTVKLVSYZEFSTPWGIMIORFMZIAVNBXKYKBGJTELWNCASZUTRUBGSWREYXCFHTWPFKDXTNLCIDUOFFGIKHRAITYUGGEWGTGATSCIYE
Juszczyński  Sebastian             : CPYDNREAXAGQHAOIDZESXWEGAYXPCEPGHEEMNNZDTUPMXVBZAOOVKCPAJZWDUVYFMVRPQGATIJPRFVJQZOJQNLTYMCOGBUHUMIIBNVCCNRSIAKFARYKHOWURLRFHUYEHALFQSDCXKNZTICNIAUKOTYPICBIRSFCHOTNHQGQVQOHWZUO
Kalisiak     Jędrzej    Michał     : DIJHLPFGCHMMZZLZFOLZVFLENUAEZYOQHYRRAWURTESCSAUMFSIWEYZHWVLJHZGXLYVEORKAIVBCSNMJPWHVKNSGXSQHSGVAEOSMWZMTMRFCZVHPJEKHAKXVOIGYOFGYGCETSLUNKDWHQZEZQDUYORAZIAVZTABPIWWZSWICWHKQPKK
Kiciński     Dawid                 : DNGTRBZUFAMJORUASHZWOPEFEJCNQDIBNQQVGQHCHBYSCUJXMWFJJCIRMWHJIOEEYJPBDCVCNEHWQZPAKAIMOGOKNFETIQOXWLFQQSXUQPFQVXXOGIZNVPNJNAWOAVDAMYCBWVVMLKPSUROKIHHRTPFFTZAGUSGOPSMKIGCQRRALDNZ
Koguciuk     Rafał                 : MJVZHUZCNVJLTCJOGVTZNCYVOVWUOPVQFRNGAGRWVCBTHHACDELVVXLSMBCGZRGSRBJUCWYWDOSXCVHPSUHPHZVKWTYEHCIJQMSGEJLKXHJFJKOHGSXDEDRFPFVIRDHHQRVETSOQCDKSEKMYBVZGXHULPGRDOMVMUKIUKMPVPKESWCM
Kowalski     Oskar      Wojciech   : YOOBNRDYFRHCGIMGSUUSHFCKCRYTDAIZITSOJFZBGIXSGEWUAWPLRBICRKMHUBHPUPSAGBNZALAPESEVFJFUMWDMUZRETBTVOMYAAGNOJHFUIMVPKEKMZHEFFBJHXUCWCSOCXWVJFZVBJVNGUGAGZRFRRQBGWTEHOVFCJXGCBJAPRLT
Kuksik       Dzmitry               : NSFTNSLNBMDDLOIETZTCVBLYGDTYIGEZOWIBLFNNHHAKIQWMCYVJIYJQZAIGXOBTRRYWTFDFFORNBJZSJRGCNHMXQSCMKQHJZCFGSSUJWSSVQKAPOPIOEQBWFHXWVIXURXULIKBJJWXZISQGWFTDCSNLUJWZZHKSXSTWJONQXPZTKPX
Lobach       Antonina              : QSRIFKDVSKEWQZCGCTEWMNBPFFXXAVXNRTRLOOVGTVUVVKQTUYZOMVFTEPPLWOMKBJCOQTQETOCAHRYZTHQGTETWNBLVEBTOBZOPUXBJFMCBHXZTATAEADRSJTWDCJKHTIUXNLCHXGQMCXBRZSIBPTJQOAXJJWMLQFNROSPVWCGBFSC
Navrotskyi   Oleh                  : EULHQXASRWFSCBRABAMTZFUUWIDUOKBAIHMYKHVHXWQTEPIMFXKMSDNVRISYXTGJOJLUCZSWULYGBCFOFVATZGQSILTDDJFHDCXIOOLTIXBOIJHPGHHAJBWSPTXSPDKPPYFRGKZIJLBKQPWQOQBZDKHPOJZTXLPKHNEFNALZVCRFDJR
Nowocień     Piotr      Robert     : OBWMWECNLABCBEOMZBWPWBCWOOAQWZLIKFFLRRUFSUOMEBMRFKMYWWZUFVEXIHPBXJUSSNMQRGTYVSVAEITZTMXJQAEHKLUHCNZKGUQAZMHRHMQDMTYAVYZYDXDJJHJOCJPDGIBUGKKHDXRGCDHBDMYLSOZETJZJZWPAEBUBUAGHOOX
Obrępalski   Paweł      Dariusz    : QEATNPKPKLPMBZWJOYKYATUFEPMPDHBCSAOHWOZOOIGLFBLCSHMFRVFAGQIVWJJAOECBEEAZRKBBUKCERLCKBHNLTENDEKDOLYRCPKNREJMPHNHOIVRVEEOBNIIFARTIMUQAHYWIXMFHGBLXNOFBDFWZALJNQKEPAXQCODDGTSOGNYE
Onoucha      Oskar                 : TWRFDNDVNHOGPGFNVQCDKIXXAFKEXETYMVLVTYITXVVYHLCWIXFJRXRIBIMSXABHNNLWSDGNJVKYEMXBHFZMXWCJMWZIUWHFQOETJPAPTITLLHTXLZUIGJKMSVBLLLOYIYGOSWUZOXREATRHCRTORKWNXTNSXFLWADKCSZMYDSPUNZL
Paluch       Maciej                : YXLKALFIHRLPVVPLKBMKFUSZKKNJOXSFUUUIPQDXJRYRYSESKIUUYFNUNFZXPNVXVLWFOIDDYFQGNDHKSXLSDCLTGVGCNASTZRMBNDUOFSIRUCNCQIQBWMUFITWLYPBLETJFVVIKBETOVNTNOEOFODETBJWCJCWDGKRIFJOZIJSHJZP
Pawliński    Maciej     Jakub      : VADSOZMJFPTYDAMEPQKRFVBEZXYXLYGBOINMMOYGWTCVKIAGRWGJDUSSRXWQHKAXRXHYWXAJDYNMMOOXWUIUDWUUNLFVZOXHNIZGRTAZCPDNCUUPABEZGTHGGHAZOPNBMORNBQPOVLPDGWAEVFGSZFTDJIWRIAJZNTILFVJAREUAPMZ
Pisarczyk    Maciej                : DRCEZUGWANCZPOIWNAELCHGASUVWDXRSOYGUMXHABXQSNOJUTSZTZPQQIAUSCDRNEBPBFNCKADYORJTXXMTSYGOBYYNPUGJHOYKBRMHKWVERZUSIEWPKTSQFXSHBXUMKQKBHGZTKTHNFGLCWXFMVHPLKUMMZZGFRKSTUGZMCCONYXMF
Puton        Piotr                 : OIQNVDGPQKXVOKKCYGDNLBOSMBEDPCJDKQJXKYVDCDQRUORRIQKQYLNIPWHVNFKEXBPCIDMQVLUPZDVVULNZYTLOUHGFOYGUANHHKNUZDKEVCWTWXDOHHANAXGMQACMQVKYPARFATOUCJHONUEOQLOZTJLSCQCCRETTIOQVFRVKMNYB
Rajkowski    Bartosz    Filip      : OMIRUOBGAIMUNMSASIOPEGPGGJXWNBUERVZDNWNSUVRXQYQWPIVLDZWORZENKOCLLPRPSPLMLFFLLUKREVRUJRFFGGKVYQDKYIQYLNXYXNQPEQIDFIYZWMMTCZRHXOCCAFBNCLGOLVIFYMACOFDFTYDWSOBUVTOQLIFUYQNWBHJANYU
Romanowski   Michał                : NRUGHPRAWDNOALNRXBHNHKZBYRMMOHEQZNRNFPYSAJQODYKSUFRNESOFKRZOUINVZEWZLIXFZKCDMBGUUVBTUAKWYXOIPPRPWJGAGEGWTGUOKFICGRJVRQKQWIIWNYEFWCMVSMEOZUBSZFYGVDNJREPALNVTCQRTOCQRGYLWQQOQVUR
Russek       Filip      Benedykt   : AAJANAMJYBBWUYCQNIPXBRHKWDVKZXKHFFTTZCFZOOJSMMOANDLCXJLTEONJRUMQXLDOLTUELGYYLLTPGMXROWHZFVTWPGMWUEZAKTZDYFOLVDEOFWPXTMSBQZDLARALFUQROGVWLPQSPUVOWFKQCSMJLJGXUIEDUSBDXWHCVAQEREJ
Sprawka      Dariusz    Mariusz    : DHDMQKYTOOINTAMXWFTPNRQBKFSHLVUWMYAYJVYXSRZMCAWAYORXXKPNVBQLWRGDOZJZNEAHAPSRJCQBQVBJQQFQOXSJFPGBVFJWCZNRTZOSRQUIMCXONGXACBGMMHOFJERCINOJQESYZWGAZOODXYWSKYWVPBAFCTWOPMYPQWJBTVN
Sroka        Marcin                : MCIETERLASUIMBFSDFSBSQQINCHFNQPDEMATPEXOZBVCYJRSSSAFUUUABBWMTFRLZHCORDOTCUOAPUZZKAZFYZITQWYFKSPYLQCFDTAYVRAGDSBXOCLDLSSJJBCBBKVINQPDQNTRMYGSFRGFJNRIJTIBBDMJRCEZLXGZDUZMMEPGSMG
Staszewski   Marcin     Józef      : LACCKSBADYWKEJYQMKXZUVHYLEPRLJSGROIRBOPHJWQQCGSSLBBCWDRPSPETPOSIBCIGTPCSXVRUDBTZGOCOLGORXUZLDKUFEQYKSKJDADLSBFAVJHUHHYEAYHKUJCUDFDFGSCRXQIVXMOPDJVNYQUGOVDOPEQBUIMJIZWHENDQGCAW
Stawowy      Tomasz     Krzysztof  : DKCDJESDTVCBMPRMOOSEANYAPMXARRWNRKVRCDEDFLRINVWSVIUXALGMQFWGSWYYRQPMJATKHURXDJPJJMBBVASLZVKKDJFIOWCVXFFTAMAUAEGZKBGKKDAVGCKLNTUMXCJJSVSCPNPAHBKTHPQGMDBUEDZBRJEHTWGJKVTFOTMOFRB
Wieczorek    Jakub      Łukasz     : JKPYFOUPTDVILCRWMCCDMQABZHMQSCCXISSMCXVLLOJNMHWBJUMUMZWAMWISKCIIRYSIRCJESRJEEGIWDEJPBGVRJCIGSHRKJUELPISXBENUQAIQRMBQNSKVHWATVRXFJFVTWJEZLSRDVZZIYDYBKVSSHKPKNOVSRAEXTEBEVZTUAWR
Wilczyński   Przemysław            : JMYBEDNGBNVRABNDSGLQZFXJEKVBDPKMVEIFCNFXBXPWAINFKAPYBVTFNIQFLUMRXYZWGKJDBHWBFJQOURXMNVAGFOSGNTSMSOCYZEKQOJXRCRFCJBDLZVAWHFINMQEJPVJVKYHJQPJMRBPTUFQTCBXJSOIIXLMZKJCKEDJEHRVHJSU
Zarzycki     Krzysztof             : EKAKXBKGAKGVQMSCTHNCVNLDQJRTAGRITOWOXFUACKEYUTMMPPXDNZMVPRHVGRCAMYIIBRSXLCAWQXWMRTKEHOGXPSWXYQZUHZUGAYOOBQNUBOKOJZLIEYCLRDYBFCKPTWJSBVIFJCHAGVVJLEIKBIMALFFGDYEOEGRNECWGYXENDCS
Zieliński    Łukasz                : HZVCKDOEVGNUNNWGDODIIYJMYVRGDIEYFIRLPWPMVUZYXMTPTJXWSGNFCPMGLDNZVACAIZLKKVPDLDRDCSKZNUWUFRAUFZYPESKMHWMUUOKRRETEIWOGYROZVRCJNQQSXOZCMCTUNLBOGCTTJENCUMYCSUSLOPBZGQDEMHNCKGPEZOS
Ziemnicki    Tomasz     Grzegorz   : YINUBTDKSBRZGGCCIVNKEZTIXPGMLHRUJLZGSWTFLPPYJNKPMYSMMGFJHHFLGLTEZGCRDLOXVMWVFRSQKBJAGVMFYESGDLHOAKIFTFJBUWZYMHSSWFKUFMUPFMZEGKUWTKGPOIGQJLLPBMYDWFMMGPVGNMUMBHSOSXAEFORIWWENZBC
